//Level 3
wwwwwwwwwwwwwww
wp  b   b  bb1w
w w w w w w w w
wb b3 b bPb b w
w w w w w w w w
w b 2b b b  ^bw
w w w w w w w w
w% b bbb b 3 bw
w w w w w w w w
w 4 b  4  bb 2w
wwwwwwwwwwwwwww