//Level 4
wwwwwwwwwwwwwww
w            Bw
w w w w w w w w
w             w
w w w w w w w w
wp            w
w w w w w w w w
w             w
w w w w w w w w
w            Bw
wwwwwwwwwwwwwww