//level 2
wwwwwwwwwwwwwww
wp            w
w w w w w w w w
w             w
w w w w w w w w
w             w
w w w w w w w w
w          D  w
w w w w w w w w
w             w
wwwwwwwwwwwwwww