//zoo
wwwwwwwwwwwwwwwww
w0    w   w D   w
w         w b b w
w    0w   w     w
ww   w     wwwwww
w       p       w
w               w
w               w
wwwwww  P  w   ww
w2    w   w3    w
w  2  b         w
w    2w   w    3w
wwwwww     w   ww
w               w
w               w
w               w
wwwwww     wwwwww
w     w   w b b w
w bBb b   w4w4w4w
w     w   w b b w
wwwwwwwwwwwwwwwww