//level 3
wwwwwwwwwwwwwwwwwwwww
wp                 Dw
w w w w w w w w w w w
wm                  w
w w w w w w w w w w w
wn                  w
w w w w w w w w w w w
wq                  w
w w w w w w w w w w w
w                  Dw
wwwwwwwwwwwwwwwwwwwww