//level 1
wwwwwwwwwwwwwwwwwwwww
wp & % b0 &bb  bb  bw
w wbw w*w w w w w w w
wb #  b @P  b % b   w
w w w w wbw w w w w w
wm &b  b% b $ bb * bw
w w w w w$w w w w w w
w! ^ b b b b @ b  b w
w wbw w w@wbw w w w w
wn b  bb q b  # b * w
wwwwwwwwwwwwwwwwwwwww