//level 2
wwwwwwwwwwwwwwwwwwwww
wp !@#             Bw
w w w w w w w w w w w
wm                  w
w w w w w w w w w w w
wn                 Bw
w w w w w w w w w w w
wq                  w
w w w w w w w w w w w
w  !@#             Bw
wwwwwwwwwwwwwwwwwwwww